xxxxxxxxxxx
x         x
x    xxx  x
x      x  x
x      x  x
x      x Ex
x Sxxxxx  x
x         x
xxxxxxxxxxx
