xxxxx
x E x
x   x
x   x
x   x
x   x
x   x
x   x
x S x
xxxxx
