###################################################################
#                                                                 #
#                                                                 #
#                                                                 #
#                                                                 #
#                                                                 #
#                                                                 #
#                                                                 #
#                                                                 #
#                                                                 #
#                                                                 #
#             S                              E                    #
#                                                                 #
#                                                                 #
#                                                                 #
#                                                                 #
#                                                                 #
#                                                                 #
#                                                                 #
#                                                                 #
#                                                                 #
#                                                                 #
#                                                                 #
###################################################################
